"a" = (/turf/space,/area/asteroid/rogue/zone1)
"b" = (/turf/space,/area/asteroid/rogue/zone2)
"c" = (/turf/unsimulated/wall/planetary/virgo3b,/area/asteroid/rogue/zone1)
"d" = (/turf/unsimulated/wall/planetary/virgo3b,/area/asteroid/rogue/zone2)
"e" = (/obj/asteroid_spawner,/turf/space,/area/asteroid/rogue/zone1)
"f" = (/obj/asteroid_spawner,/turf/space,/area/asteroid/rogue/zone2)
"g" = (/obj/rogue_mobspawner,/turf/space,/area/asteroid/rogue/zone2)
"h" = (/obj/rogue_mobspawner,/turf/space,/area/asteroid/rogue/zone1)
"i" = (/turf/space,/area/shuttle/belter/belt/zone1)
"j" = (/turf/space,/area/shuttle/belter/belt/zone2)
"k" = (/turf/space,/area/asteroid/rogue/zone3)
"l" = (/turf/space,/area/asteroid/rogue/zone4)
"m" = (/turf/unsimulated/wall/planetary/virgo3b,/area/asteroid/rogue/zone3)
"n" = (/turf/unsimulated/wall/planetary/virgo3b,/area/asteroid/rogue/zone4)
"o" = (/obj/asteroid_spawner,/turf/space,/area/asteroid/rogue/zone3)
"p" = (/obj/asteroid_spawner,/turf/space,/area/asteroid/rogue/zone4)
"q" = (/obj/rogue_mobspawner,/turf/space,/area/asteroid/rogue/zone3)
"r" = (/obj/rogue_mobspawner,/turf/space,/area/asteroid/rogue/zone4)
"s" = (/turf/space,/area/shuttle/belter/belt/zone4)
"t" = (/turf/space,/area/shuttle/belter/belt/zone3)

(1,1,1) = {"
aaaaaaaaaaaaaaaaaaaaaaaaaaaaaaaaaaaaaaaaaaaaaaaaaabbbbbbbbbbbbbbbbbbbbbbbbbbbbbbbbbbbbbbbbbbbbbbbbbb
aaaaaaacccccccccccccccccccccccccccccccccccccccccaabbddddddddddddddddddddddddddddddddddddddddddddddbb
aaaaaacaaaaaaaaaaaaaaaaaaaaaaaaaaaaaaaaaaaaaaaaacabdbbbbbbbbbbbbbbbbbbbbbbbbbbbbbbbbbbbbbbbbbbbbbbdb
aaaaaacaaaaaaaaaaaaaaaaaaaaaaaaaaaaaaaaaaaaaaaaacabdbbbbbbbbbbbbbbbbbbbbbbbbbbbbbbbbbbbbbbbbbbbbbbdb
aaaaaacaaaaaaaaaaaaaaaaaaaaaaaaaaaaaaaaaaaaaaaaacabdbbbbbbbbbbbbbbbbbbbbbbbbbbbbbbbbbbbbbbbbbbbbbbdb
aaaaaacaaaaaaaaaaaaaaaaaaaaaaaaaaaaaaaaaaaaaaaaacabdbbbbbbbbbbbbbbbbbbbbbbbbbbbbbbbbbbbbbbbbbbbbbbdb
aaaaaacaaaaaaaaaaaaaaaaaaaaaaaaaaaaaaaaaaeaaaaaacabdbbbbbbbbbbbbbbbbbbbbbbbbbbbbbbbbfbbbbbbbbbbbbbdb
aaaaaacaaaaaeaaaaaaaaaaaaeaaaaaaaaaaaaaaaaaaaaaacabdbbbbbbbbbbbbbbbbbbbbbbbbbbbbbbbbbbbbbbbbbbbbbbdb
aaaaaacaaaaaaaaaaaaaaaaaaaaaaaaaaaaaaaaaaaaaaaaacabdbbbbbbbbbbbbbbbbbbbbbbbbbbbbbbbbbbbbbbbbbbbbbbdb
aaaaaacaaaaaaaaaaaaeaaaaaaaaaaaaaaaaaaaaaaaaaaaacabdbbbbbbbbbbbbbbbbbbbbbbbbbbbbbbbbbbbbbbbbbbbbbbdb
aaaaaacaaaaaaaaaaaaaaaaaaaaaaaaaaaaaaaaaaaaaaaaacabdbbbbbbbbbbbbbbgbbbbbbbfbbbbbbbbbbbbbbgbbbbbbbbdb
aaaaaacaaaaaaaaaaaaaaaaaaaaaaaaaaaaaaaaaaaaaaaaacabdbbbbbbbbbbbbbbbbbbbbbbbbbbbbbbgbbbbbbbbbbbbbbbdb
aaaaaacaaaaaaaaaaaaaaaaaaaaaaaaaaaaaaaaaaaaaaaaacabdbbbbbbbbbbbbbbbbbbbbbbbbbbbbbbbbbbbbbbbbbbbbbbdb
aaaaaacaaaaaeaaaaaaaaaaahaaaaaaaeaaaaaaaaahaaaaacabdbbbbbbbbbbbbbbbbbbbbbbbbbbbbbbbbbbbbbbbbbbbbbbdb
aaaaaacaaaaaaaaaaaaaaaaaaaaaaaaaaaaaaaaaaaaaaaaacabdbbbbbbbbbbbbbbbbbbbbbbbbbbbbbbbbbbbbbbbbbbbbbbdb
aaaaaacaaaaaaaaaaaaaaaaaaaaaaaaaaaaaaaaaaaaaaaaacabdbbbbbbbbbbgbbbbbbbgbbbbbbbbbbbbbbbbbbfbbbbbbbbdb
aaaaaacaaaaaaaaaaaaaaaaaaaaaaaaaaaaaaaaaaaaaaaaacabdbbbbbbbbbbbbbbbbbbbbbbbbfbbbbbgbbbbbbbbbbbbbbbdb
aaaaaacaaaaaaaaaaaaaaaaaaaaaaaaaaaaaaaaaaaaaaaaacabdbbbbbbbbbbbbbbbfbbbbbbbbbbbbbbbbbbbbbbbbbbbbbbdb
aaaaaacaaaaaaaaaaaahaaaaaaaaaaaaaaaaaaaaaaaaaaaacabdbbbbbbbbbbbbbbbbbbbbbbbbbbbbbbbbbbbbbbbbbbbbbbdb
aaaaaacaaaaaaaaaaaaaaaaaaaaiiiaaaaaaaaaaaaaaaaaacabdbbbbbbfbbbbbbbbbbbbbbbbbbbbbbbbbbbbbbbbbbbbbbbdb
aaaaaacaaaahaaaaaaaaaaaaaaiiiiiiiiiiaaaaaaaaaaaacabdbbbbbbbbbbbbbbbbbbbbbgbbbbbbbbbbbbbbbbbbgbbbbbdb
aaaaaacaaaaaaaaaaaaaaaaaaaiiiiiiiiiiaaaaaaaaaaaacabdbbbbbbbbbbgbbbbbbbbbbbbbbbbbgbbbbbbbbbbbbbbbbbdb
aaaaaacaaaaaaaaaaaaaeaaaaaiiiiiiiiiiaaaaaaaaaaaacabdbbbbbbbbbbbbbbbbbbbbbbbbbbbbbbbbbbbbbbbbbbbbbbdb
aaaaaacaaaaaaaaaaaaaaaaaaaiiiiiiiiiiaaaaaaaaeaaacabdbbbbbbbbbbbbbbbbbbbbbbbbbbbbbbbbbbbbbbbbbbbbbbdb
aaaaaacaaaaeaaaaaaaaaaaaaaiiiiiiiiiiaaaaaaaaaaaacabdbbbbbbbbbbbbbbbbbbbbbbbbbbbbbbbbbbbbbbbbbbbbbbdb
aaaaaacaaaaaaaaaaaaaaaaaaaiiiiiiiiiiaaaaaaaaaaaacabdbbbbbbbbbbbbbbbbbbbbbbbbbbbbbbbbgbbbbbbfbbbbbbdb
aaaaaacaaaaaaaaaahaaaaaaaaaiiiaaaaaaaaaaaaaaaaaacabdbbbbbbbbfbbbbbbbbbbbbbbbbbbbbbbbbbbbbbbbbbbbbbdb
aaaaaacaaaaaaaaaaaaaaaaaaaaaaaaaaaaaaaaaaaaaaaaacabdbbbbbbbbbbbbbbbbbbbbbbbbbbbbbbbbbbbbbbbbbbbbbbdb
aaaaaacaaaaeaaaaaaaaaaaaaaaaaaaaaaaaaaaaaaaaaaaacabdbbbbbbbbbbbbbbbbbbbbbbbbbbbbbbbbbbbbbbbbbbbbbbdb
aaaaaacaaaaaaaaaaaaaaaaaaaaaaaaaaaaaaaaaaaaaaaaacabdbbbbbbbbbbbbgbbbbbbbjjjbbbbbbbbbbbbbbbbbbbbbbbdb
aaaaaacaaaaaaaaaaaaaaaaaaaaaaaaaaaaaaaaaaaaaaaaacabdbbbbbbbgbbbbbbbbbbbjjjjjjjjjjbbbbbbbbbbbbbbbbbdb
aaaaaacaaaaaaaaaaaaaaaaaaaaaaaaaaaahaaaaaaaaaaaacabdbbbbbbbbbbbbbbbbbbbjjjjjjjjjjbbbbbfbbbbbbbbbbbdb
aaaaaacaaaaaaaaaaaaaaaaaaeaaaaaaaaaaaaaaeaaaaaaacabdbbbbbbbbbbbbbbbbbbbjjjjjjjjjjbbbbbbbbbbbbbbbbbdb
aaaaaacaaaaaaaaeaaaaaaaaaaaaaaaaaaaaaaaaaaaaaaaacabdbbbbbbbbbbbbbbbbbbbjjjjjjjjjjbbbbbbbbbbbbbbbbbdb
aaaaaacaaaaaaaaaaaaaaaaaaaaaaaaaaaaaaaaaaaaaaaaacabdbbbbbbbbbbbbbbbbbbbjjjjjjjjjjbbbbbbbbbbbbbbbbbdb
aaaaaacaaaaaaaaaaaaaaaaaaaaaaaaaaaaaaaaaaaaaaaaacabdbbbbbbbbbbbbbbbbbbbjjjjjjjjjjbbbbbbbbbbbbbbbbbdb
aaaaaacaaahaaaaaaaaaaaaaaaaahaaaaaeaaaaaaaaaaaaacabdbbbbbbbbbbbbbbbbbbbbjjjbbbbbbbbbbbbbbbbbbbbbbbdb
aaaaaacaaaaaaaaaaaaaaaaaaaaaaaaaaaaaaaaaaaaaaaaacabdbbbbbbbbbbbbbbbbbbbbbbbbbbbbbbbbbbbbbbbbbbbbbbdb
aaaaaacaaaaaaaaaaaahaaaaaaaaaaaaaaaaaaaaaaaaaaaacabdbbbbbbbbbfbbbbbbbbbbbbbbbbbbbbbbbbbbbbbbbbbbbbdb
aaaaaacaaaaaaaaaaaaaaaaaaaaaaaaaaaaaaaaaaaaaaaaacabdbbbbbbbbbbbbbbbbbgbbbbbbbbbbbbbbbbbbbbbbbbbbbbdb
aaaaaacaaaaaaaaaaaaaaaaaaaaaaaaaaaaaaaaaeaaaaaaacabdbbbbbbbbbbbbbbbbbbbbbbbbbbbbbbbbbbbbbbbbbbbbbbdb
aaaaaacaaaeaaaaaaaaaaaaaaaaaaaaaaaaaaaaaaaaaaaaacabdbbbbbbbbbbbbbbbbbbbbbbgbbbbbbbbbbbbbbbbbbbbbbbdb
aaaaaacaaaaaaaaaaaaaaaaaaaaaaaaaaaaaaaaaaaaaaaaacabdbbbbbbgbbbbbbbbbbbbbbbbbbbbbbbbbbbbbbgbbbbbbbbdb
aaaaaacaaaaaaaaaaaaaeaaaaaaaaaaaaaaaaaaaaaaaaaaacabdbbbbbbbbbbbbbbbbbbbbbbbbbbbbbbbbbbbbbbbbbbbbbbdb
aaaaaacaaaaaaaaaaaaaaaaaaaaaaaaaaaaaaaaaaaaaaaaacabdbbbbbbbbbbbbbbbbbbbbbbbbbbbbbbbbbbbbbbbbbbbbbbdb
aaaaaacaaaaaaaaaaaaaaaaaaaaaaaaaaaaaaaaaaaaaaaaacabdbbbbbbbbbbbbbbbbbbbbbbbbbbbbbbbbbbbbbbbbbbbbbbdb
aaaaaacaaaaaaaaaaaaaaaaaaaaaaaaaaaaaaaaaaaaaaaaacabdbbbbbbbbbbbbbbbbbbbbbbbbbbbbbbbbbbbbbbbbbbbbbbdb
aaaaaaacccccccccccccccccccccccccccccccccccccccccaabbddddddddddddddddddddddddddddddddddddddddddddddbb
aaaaaaaaaaaaaaaaaaaaaaaaaaaaaaaaaaaaaaaaaaaaaaaaaabbbbbbbbbbbbbbbbbbbbbbbbbbbbbbbbbbbbbbbbbbbbbbbbbb
kkkkkkkkkkkkkkkkkkkkkkkkkkkkkkkkkkkkkkkkkkkkkkkkkkllllllllllllllllllllllllllllllllllllllllllllllllll
kkkkkkkmmmmmmmmmmmmmmmmmmmmmmmmmmmmmmmmmmmmmmmmmkkllnnnnnnnnnnnnnnnnnnnnnnnnnnnnnnnnnnnnnnnnnnnnnnll
kkkkkkmkkkkkkkkkkkkkkkkkkkkkkkkkkkkkkkkkkkkkkkkkmklnllllllllllllllllllllllllllllllllllllllllllllllnl
kkkkkkmkkkkkkkkkkkkkkkkkkkkkkkkkkkkkkkkkkkkkkkkkmklnllllllllllllllllllllllllllllllllllllllllllllllnl
kkkkkkmkkkkkkkkkkkkkkkkkkkkkkkkkkkkkkkkkkkkkkkkkmklnllllllllllllllllllllllllllllllllllllllllllllllnl
kkkkkkmkkkkokkkkkkkkkkkkkkkkkkkkkkkkkkkkkkkkkkkkmklnllllllllllllllllllllllllllllllllllllllllllllllnl
kkkkkkmkkkkkkkkkkkkkkkkkkkkkkkkkkkkkkkkkkkkkkkkkmklnllllplllllllllllllllllllllllllllllllllplllllllnl
kkkkkkmkkkkkkkkkkkkkkkokkkkkkqkkkkkkkkkkkkkkkkkkmklnllllllllllllllllllllllllllllllllllllllllllllllnl
kkkkkkmkkkkkkkqkkkkkkkkkkkkkkkkkkkkkkkkkkkkkkkkkmklnllllllllllllllllllllllllllllplllllllllllllllllnl
kkkkkkmkkkkkkkkkkkkkkkkkkkkkkkkkkkkkkkkkkkkkkkkkmklnllllllllllllllllllllllllllllllllllllllllllllllnl
kkkkkkmkkkkkkkkkkkkkkkkkkkkkkkkkkkkkkkkkkkkkkkkkmklnllllllllllllllllllllllllllllllllllllllllllllllnl
kkkkkkmkkkkkkkkkkkkkkkqkkkkkkkkkkkkkkkkkkkkkkkkkmklnllllllllllllllllllllllllllllllllllllllllllllllnl
kkkkkkmkkkkkkkkkkkkkkkkkkkkkqkkkkkkkkkkkqkkkkkkkmklnllllllllllllllllllplllllllllllllllllllllllllllnl
kkkkkkmkkkkkokkkkkkkkkkkkkkkkkkkkkokkkkkkkkkkkkkmklnlllllllllllllllllllllllllllllllllrllllplllllllnl
kkkkkkmkkkkkkkkkkkkkkkkkkkkkkkkkkkkkkkkkkkkkkkkkmklnllllllllrlllllllllllllllllrlllllllllllllllllllnl
kkkkkkmkkkkkkkkkkkkkkkkkkkkkkkkkkkkkkkkkkkkkkkkkmklnllllllllllllllllllllllllllllllllllllllllllllllnl
kkkkkkmkkkkkkkkkkkkkkkkkkkkkkkkkkkkqkkkkkkkkkkkkmklnllllllllllllllllllllllllllllllllllllllllllllllnl
kkkkkkmkkkkkkkkkqkkkkkkkkkkkkkkkkkkkkkkkkkkkkkkkmklnllllllllllllllssslllllllllllllllllllllllllllllnl
kkkkkkmkkqkkkkkkkkkkkkkkkkkkkkkkkkkkkkkkkkkkkkkkmklnlllllllllllllsssssssssslllllllllllllllllllllllnl
kkkkkkmkkkkkkkkkkkkkkkkkkkktttkkkkkkkkkkkkokkkkkmklnllllllpllllllsssssssssslllllllllllplllllllllllnl
kkkkkkmkkkkkkkkkkkkkkkokkkttttttttttkkkkkkkkkkkkmklnlllllllllllllsssssssssslllllllllllllllllllllllnl
kkkkkkmkkkkkkkkkkkkkkkkkkkttttttttttkkkkkkkkkkkkmklnlllllllllllllssssssssssllllpllllllllllrlllllllnl
kkkkkkmkkkkkkkkkkkkkkkkkkkttttttttttkkkkqkkkkkkkmklnlllllllllllllsssssssssslllllllllllllllllllllllnl
kkkkkkmkkkkkkkkkokkkkkkkkkttttttttttkkkkkkkkkkkkmklnlllllllllllllsssssssssslllllllllllllllllllllllnl
kkkkkkmkkkkkkkkkkkkkkkkkkkttttttttttkkkkkkkkkkkkmklnlllllpllllllllssslllllllllllllllllllllllllllllnl
kkkkkkmkkkkqkkkkkkkkkkkkkkttttttttttkkkkkkkkkkkkmklnllllllllllllllllllllllllllllllllllllllllllllllnl
kkkkkkmkkkkkkkkkkkkkkkkkkkktttkkkkkkkkkkkkokkkkkmklnllllllllllllllllllllllpllllllrllllllllllllllllnl
kkkkkkmkkkkkkkkkkkkkkkkokkkkkkkkkkkqkkkkkkkkkkkkmklnlllllllllllllllllllllllllllllllllllpllllllllllnl
kkkkkkmkkkkkkkkkkkkkkkkkkkkkkkkkkkkkkkkkkkkkkkkkmklnllllllllllllllllllllllllllllllllllllllllllllllnl
kkkkkkmkkkkkkkkkkkkkkkkkkkkkkkkkkkkkkkkkkkkkkkkkmklnllllllllllllllllllllllllllllllllllllllllllllllnl
kkkkkkmkkkkkkkkkkkkkkkkkkkkkkkkkkkkkkokkkkkkkkkkmklnllllllllllllllllllllllllllllllllllllllllllllllnl
kkkkkkmkkkkkkkkkqkkkkkkkkkqkkkkkkkkkkkkkqkkkkkkkmklnlllllllllllllllpllllllllllllllllllllllllllllllnl
kkkkkkmkkkkkkkkkkkkkkkkkkkkkkkkkkokkkkkkkkkkkkkkmklnlllllllrlllllllllllllllrllllllllllllrlllllllllnl
kkkkkkmkkkkkkkkkkkkkkkkkkkkkkkkkkkkkkkkkkkkkkkkkmklnllllllllllllllllllllllllllllllplllllllllllllllnl
kkkkkkmkkkkkkkkkkkkkkkkkkkkkkkkkkkkkkkkkkkkkkkkkmklnllllllllllllllllllllllllllllllllllllllllllllllnl
kkkkkkmkkkkqkkkkkkkkkkkkkkkkkkkkkkkkkkkkkkkkkkkkmklnllllllllllllllllllllllllllllllllllllllllllllllnl
kkkkkkmkkkkkkkkkkkkkkkkkkkkkkkkkkkkkkkkkkkkkkkkkmklnllllllllllllllllllllllllllllllllllllllllllllllnl
kkkkkkmkkkkkkkkkkkkkkkkkkkkkkkqkkkkkkkkkkkkkkkkkmklnllllllllllllllllllllllllllllllllllllllllllllllnl
kkkkkkmkkkkkkkokkkkkkkokkkkkkkkkkkkkkkkkkkkkkkkkmklnlllllllpllllllllllllllllllllllllllllllllplllllnl
kkkkkkmkkkkkkkkkkkkkkkkkkkkkkkkkkkkkkkkkkkkkkkkkmklnlllllllllllllllllllllpllllllllllllllllllllllllnl
kkkkkkmkkkkkkkkkkkkkkkkkkkkkkkkkkkkkkqkkkkkkkkkkmklnllllllllllllrlllllllllllllllllllllllllllllllllnl
kkkkkkmkkkkqkkkkkokkkkkkkkkkkkkkokkkkkkkkkkkkkkkmklnlllllllllllllllllllllllllllllllllpllllllllllllnl
kkkkkkmkkkkkkkkkkkkkkkkkqkkkkkkkkkkkkkkkkkkkkkkkmklnllllllllllllllllllllllllllllrlllllllllllllllllnl
kkkkkkmkkkkkkkkkkkkkkkkkkkkkkkkkkkkkkkkkkkkkkkkkmklnllllllllllllllllllllllllllllllllllllllllllllllnl
kkkkkkmkkkkkkkkkkkkkkkkkkkkkkkkkkkkkkkkkkkkkkkkkmklnllllllllllllllllllllllllllllllllllllllllllllllnl
kkkkkkkmmmmmmmmmmmmmmmmmmmmmmmmmmmmmmmmmmmmmmmmmkkllnnnnnnnnnnnnnnnnnnnnnnnnnnnnnnnnnnnnnnnnnnnnnnll
kkkkkkkkkkkkkkkkkkkkkkkkkkkkkkkkkkkkkkkkkkkkkkkkkkllllllllllllllllllllllllllllllllllllllllllllllllll
kkkkkkkkkkkkkkkkkkkkkkkkkkkkkkkkkkkkkkkkkkkkkkkkkkllllllllllllllllllllllllllllllllllllllllllllllllll
kkkkkkkkkkkkkkkkkkkkkkkkkkkkkkkkkkkkkkkkkkkkkkkkkkllllllllllllllllllllllllllllllllllllllllllllllllll
kkkkkkkkkkkkkkkkkkkkkkkkkkkkkkkkkkkkkkkkkkkkkkkkkkllllllllllllllllllllllllllllllllllllllllllllllllll
kkkkkkkkkkkkkkkkkkkkkkkkkkkkkkkkkkkkkkkkkkkkkkkkkkllllllllllllllllllllllllllllllllllllllllllllllllll
"}
