"a" = (/turf/space,/area/asteroid/rogue/zone1)
"b" = (/turf/space,/area/asteroid/rogue/zone2)
"c" = (/obj/effect/step_trigger/teleporter/random/rogue/fourbyfour/onleft,/turf/space,/area/asteroid/rogue/zone1)
"d" = (/obj/effect/step_trigger/teleporter/random/rogue/fourbyfour/ontop,/turf/space,/area/asteroid/rogue/zone1)
"e" = (/obj/asteroid_spawner,/turf/space,/area/asteroid/rogue/zone1)
"f" = (/obj/asteroid_spawner,/turf/space,/area/asteroid/rogue/zone2)
"g" = (/obj/rogue_mobspawner,/turf/space,/area/asteroid/rogue/zone2)
"h" = (/obj/rogue_mobspawner,/turf/space,/area/asteroid/rogue/zone1)
"i" = (/turf/space,/area/shuttle/belter/belt/zone1)
"j" = (/turf/space,/area/shuttle/belter/belt/zone2)
"k" = (/turf/space,/area/asteroid/rogue/zone3)
"l" = (/turf/space,/area/asteroid/rogue/zone4)
"m" = (/obj/effect/step_trigger/teleporter/random/rogue/fourbyfour/ontop,/turf/space,/area/asteroid/rogue/zone2)
"o" = (/obj/asteroid_spawner,/turf/space,/area/asteroid/rogue/zone3)
"p" = (/obj/asteroid_spawner,/turf/space,/area/asteroid/rogue/zone4)
"q" = (/obj/rogue_mobspawner,/turf/space,/area/asteroid/rogue/zone3)
"r" = (/obj/rogue_mobspawner,/turf/space,/area/asteroid/rogue/zone4)
"s" = (/turf/space,/area/shuttle/belter/belt/zone4)
"t" = (/turf/space,/area/shuttle/belter/belt/zone3)
"v" = (/obj/effect/step_trigger/teleporter/random/rogue/fourbyfour/onright,/turf/space,/area/asteroid/rogue/zone2)
"y" = (/obj/effect/step_trigger/teleporter/random/rogue/fourbyfour/onleft,/turf/space,/area/asteroid/rogue/zone3)
"B" = (/obj/effect/step_trigger/teleporter/random/rogue/fourbyfour/onright,/turf/space,/area/asteroid/rogue/zone4)
"E" = (/obj/effect/step_trigger/teleporter/random/rogue/fourbyfour/onbottom,/turf/space,/area/asteroid/rogue/zone3)
"F" = (/obj/effect/step_trigger/teleporter/random/rogue/fourbyfour/onbottom,/turf/space,/area/asteroid/rogue/zone4)

(1,1,1) = {"
aaaaaaaaaaaaaaaaaaaaaaaaaaaaaaaaaaaaaaaaaaaaaaaaaabbbbbbbbbbbbbbbbbbbbbbbbbbbbbbbbbbbbbbbbbbbbbbbbbb
acddddddddddddddddddddddddddddddddddddddddddddddaabbmmmmmmmmmmmmmmmmmmmmmmmmmmmmmmmmmmmmmmmmmmmmmmmb
acaaaaaaaaaaaaaaaaaaaaaaaaaaaaaaaaaaaaaaaaaaaaaaaabbbbbbbbbbbbbbbbbbbbbbbbbbbbbbbbbbbbbbbbbbbbbbbbvb
acaaaaaaaaaaaaaaaaaaaaaaaaaaaaaaaaaaaaaaaaaaaaaaaabbbbbbbbbbbbbbbbbbbbbbbbbbbbbbbbbbbbbbbbbbbbbbbbvb
acaaaaaaaaaaaaaaaaaaaaaaaaaaaaaaaaaaaaaaaaaaaaaaaabbbbbbbbbbbbbbbbbbbbbbbbbbbbbbbbbbbbbbbbbbbbbbbbvb
acaaaaaaaaaaaaaaaaaaaaaaaaaaaaaaaaaaaaaaaaaaaaaaaabbbbbbbbbbbbbbbbbbbbbbbbbbbbbbbbbbbbbbbbbbbbbbbbvb
acaaaaaaaaaaaaaaaaaaaaaaaaaaaaaaaaaaaaaaaeaaaaaaaabbbbbbbbbbbbbbbbbbbbbbbbbbbbbbbbbbfbbbbbbbbbbbbbvb
acaaaaaaaaaaeaaaaaaaaaaaaeaaaaaaaaaaaaaaaaaaaaaaaabbbbbbbbbbbbbbbbbbbbbbbbbbbbbbbbbbbbbbbbbbbbbbbbvb
acaaaaaaaaaaaaaaaaaaaaaaaaaaaaaaaaaaaaaaaaaaaaaaaabbbbbbbbbbbbbbbbbbbbbbbbbbbbbbbbbbbbbbbbbbbbbbbbvb
acaaaaaaaaaaaaaaaaaeaaaaaaaaaaaaaaaaaaaaaaaaaaaaaabbbbbbbbbbbbbbbbbbbbbbbbbbbbbbbbbbbbbbbbbbbbbbbbvb
acaaaaaaaaaaaaaaaaaaaaaaaaaaaaaaaaaaaaaaaaaaaaaaaabbbbbbbbbbbbbbbbgbbbbbbbfbbbbbbbbbbbbbbgbbbbbbbbvb
acaaaaaaaaaaaaaaaaaaaaaaaaaaaaaaaaaaaaaaaaaaaaaaaabbbbbbbbbbbbbbbbbbbbbbbbbbbbbbbbgbbbbbbbbbbbbbbbvb
acaaaaaaaaaaaaaaaaaaaaaaaaaaaaaaaaaaaaaaaaaaaaaaaabbbbbbbbbbbbbbbbbbbbbbbbbbbbbbbbbbbbbbbbbbbbbbbbvb
acaaaaaaaaaaeaaaaaaaaaaahaaaaaaaeaaaaaaaaahaaaaaaabbbbbbbbbbbbbbbbbbbbbbbbbbbbbbbbbbbbbbbbbbbbbbbbvb
acaaaaaaaaaaaaaaaaaaaaaaaaaaaaaaaaaaaaaaaaaaaaaaaabbbbbbbbbbbbbbbbbbbbbbbbbbbbbbbbbbbbbbbbbbbbbbbbvb
acaaaaaaaaaaaaaaaaaaaaaaaaaaaaaaaaaaaaaaaaaaaaaaaabbbbbbbbbbbbgbbbbbbbgbbbbbbbbbbbbbbbbbbfbbbbbbbbvb
acaaaaaaaaaaaaaaaaaaaaaaaaaaaaaaaaaaaaaaaaaaaaaaaabbbbbbbbbbbbbbbbbbbbbbbbbbfbbbbbgbbbbbbbbbbbbbbbvb
acaaaaaaaaaaaaaaaaaaaaaaaaaaaaaaaaaaaaaaaaaaaaaaaabbbbbbbbbbbbbbbbbfbbbbbbbbbbbbbbbbbbbbbbbbbbbbbbvb
acaaaaaaaaaaaaaaaaahaaaaaaaaaaaaaaaaaaaaaaaaaaaaaabbbbbbbbbbbbbbbbbbbbbbbbbbbbbbbbbbbbbbbbbbbbbbbbvb
acaaaaaaaaaaaaaaaaaaaaaaaaaiiiaaaaaaaaaaaaaaaaaaaabbbbbbbbfbbbbbbbbbbbbbbbbbbbbbbbbbbbbbbbbbbbbbbbvb
acaaaaaaaaahaaaaaaaaaaaaaaiiiiiiiiiiaaaaaaaaaaaaaabbbbbbbbbbbbbbbbbbbbbbbgbbbbbbbbbbbbbbbbbbgbbbbbvb
acaaaaaaaaaaaaaaaaaaaaaaaaiiiiiiiiiiaaaaaaaaaaaaaabbbbbbbbbbbbgbbbbbbbbbbbbbbbbbgbbbbbbbbbbbbbbbbbvb
acaaaaaaaaaaaaaaaaaaeaaaaaiiiiiiiiiiaaaaaaaaaaaaaabbbbbbbbbbbbbbbbbbbbbbbbbbbbbbbbbbbbbbbbbbbbbbbbvb
acaaaaaaaaaaaaaaaaaaaaaaaaiiiiiiiiiiaaaaaaaaeaaaaabbbbbbbbbbbbbbbbbbbbbbbbbbbbbbbbbbbbbbbbbbbbbbbbvb
acaaaaaaaaaeaaaaaaaaaaaaaaiiiiiiiiiiaaaaaaaaaaaaaabbbbbbbbbbbbbbbbbbbbbbbbbbbbbbbbbbbbbbbbbbbbbbbbvb
acaaaaaaaaaaaaaaaaaaaaaaaaiiiiiiiiiiaaaaaaaaaaaaaabbbbbbbbbbbbbbbbbbbbbbbbbbbbbbbbbbgbbbbbbfbbbbbbvb
acaaaaaaaaaaaaaaahaaaaaaaaaiiiaaaaaaaaaaaaaaaaaaaabbbbbbbbbbfbbbbbbbbbbbbbbbbbbbbbbbbbbbbbbbbbbbbbvb
acaaaaaaaaaaaaaaaaaaaaaaaaaaaaaaaaaaaaaaaaaaaaaaaabbbbbbbbbbbbbbbbbbbbbbbbbbbbbbbbbbbbbbbbbbbbbbbbvb
acaaaaaaaaaeaaaaaaaaaaaaaaaaaaaaaaaaaaaaaaaaaaaaaabbbbbbbbbbbbbbbbbbbbbbbbbbbbbbbbbbbbbbbbbbbbbbbbvb
acaaaaaaaaaaaaaaaaaaaaaaaaaaaaaaaaaaaaaaaaaaaaaaaabbbbbbbbbbbbbbgbbbbbbbjjjbbbbbbbbbbbbbbbbbbbbbbbvb
acaaaaaaaaaaaaaaaaaaaaaaaaaaaaaaaaaaaaaaaaaaaaaaaabbbbbbbbbgbbbbbbbbbbbjjjjjjjjjjbbbbbbbbbbbbbbbbbvb
acaaaaaaaaaaaaaaaaaaaaaaaaaaaaaaaaahaaaaaaaaaaaaaabbbbbbbbbbbbbbbbbbbbbjjjjjjjjjjbbbbbfbbbbbbbbbbbvb
acaaaaaaaaaaaaaaaaaaaaaaaeaaaaaaaaaaaaaaeaaaaaaaaabbbbbbbbbbbbbbbbbbbbbjjjjjjjjjjbbbbbbbbbbbbbbbbbvb
acaaaaaaaaaaaaaeaaaaaaaaaaaaaaaaaaaaaaaaaaaaaaaaaabbbbbbbbbbbbbbbbbbbbbjjjjjjjjjjbbbbbbbbbbbbbbbbbvb
acaaaaaaaaaaaaaaaaaaaaaaaaaaaaaaaaaaaaaaaaaaaaaaaabbbbbbbbbbbbbbbbbbbbbjjjjjjjjjjbbbbbbbbbbbbbbbbbvb
acaaaaaaaaaaaaaaaaaaaaaaaaaaaaaaaaaaaaaaaaaaaaaaaabbbbbbbbbbbbbbbbbbbbbjjjjjjjjjjbbbbbbbbbbbbbbbbbvb
acaaaaaaaahaaaaaaaaaaaaaaaaahaaaaaeaaaaaaaaaaaaaaabbbbbbbbbbbbbbbbbbbbbbjjjbbbbbbbbbbbbbbbbbbbbbbbvb
acaaaaaaaaaaaaaaaaaaaaaaaaaaaaaaaaaaaaaaaaaaaaaaaabbbbbbbbbbbbbbbbbbbbbbbbbbbbbbbbbbbbbbbbbbbbbbbbvb
acaaaaaaaaaaaaaaaaahaaaaaaaaaaaaaaaaaaaaaaaaaaaaaabbbbbbbbbbbfbbbbbbbbbbbbbbbbbbbbbbbbbbbbbbbbbbbbvb
acaaaaaaaaaaaaaaaaaaaaaaaaaaaaaaaaaaaaaaaaaaaaaaaabbbbbbbbbbbbbbbbbbbgbbbbbbbbbbbbbbbbbbbbbbbbbbbbvb
acaaaaaaaaaaaaaaaaaaaaaaaaaaaaaaaaaaaaaaeaaaaaaaaabbbbbbbbbbbbbbbbbbbbbbbbbbbbbbbbbbbbbbbbbbbbbbbbvb
acaaaaaaaaeaaaaaaaaaaaaaaaaaaaaaaaaaaaaaaaaaaaaaaabbbbbbbbbbbbbbbbbbbbbbbbgbbbbbbbbbbbbbbbbbbbbbbbvb
acaaaaaaaaaaaaaaaaaaaaaaaaaaaaaaaaaaaaaaaaaaaaaaaabbbbbbbbgbbbbbbbbbbbbbbbbbbbbbbbbbbbbbbgbbbbbbbbvb
acaaaaaaaaaaaaaaaaaaeaaaaaaaaaaaaaaaaaaaaaaaaaaaaabbbbbbbbbbbbbbbbbbbbbbbbbbbbbbbbbbbbbbbbbbbbbbbbvb
acaaaaaaaaaaaaaaaaaaaaaaaaaaaaaaaaaaaaaaaaaaaaaaaabbbbbbbbbbbbbbbbbbbbbbbbbbbbbbbbbbbbbbbbbbbbbbbbvb
acaaaaaaaaaaaaaaaaaaaaaaaaaaaaaaaaaaaaaaaaaaaaaaaabbbbbbbbbbbbbbbbbbbbbbbbbbbbbbbbbbbbbbbbbbbbbbbbvb
acaaaaaaaaaaaaaaaaaaaaaaaaaaaaaaaaaaaaaaaaaaaaaaaabbbbbbbbbbbbbbbbbbbbbbbbbbbbbbbbbbbbbbbbbbbbbbbbvb
acaaaaaaaaaaaaaaaaaaaaaaaaaaaaaaaaaaaaaaaaaaaaaaaabbbbbbbbbbbbbbbbbbbbbbbbbbbbbbbbbbbbbbbbbbbbbbbbvb
acaaaaaaaaaaaaaaaaaaaaaaaaaaaaaaaaaaaaaaaaaaaaaaaabbbbbbbbbbbbbbbbbbbbbbbbbbbbbbbbbbbbbbbbbbbbbbbbvb
kykkkkkkkkkkkkkkkkkkkkkkkkkkkkkkkkkkkkkkkkkkkkkkkkllllllllllllllllllllllllllllllllllllllllllllllllBl
kykkkkkkkkkkkkkkkkkkkkkkkkkkkkkkkkkkkkkkkkkkkkkkkkllllllllllllllllllllllllllllllllllllllllllllllllBl
kykkkkkkkkkkkkkkkkkkkkkkkkkkkkkkkkkkkkkkkkkkkkkkkkllllllllllllllllllllllllllllllllllllllllllllllllBl
kykkkkkkkkkkkkkkkkkkkkkkkkkkkkkkkkkkkkkkkkkkkkkkkkllllllllllllllllllllllllllllllllllllllllllllllllBl
kykkkkkkkkkkkkkkkkkkkkkkkkkkkkkkkkkkkkkkkkkkkkkkkkllllllllllllllllllllllllllllllllllllllllllllllllBl
kykkkkkkkkkokkkkkkkkkkkkkkkkkkkkkkkkkkkkkkkkkkkkkkllllllllllllllllllllllllllllllllllllllllllllllllBl
kykkkkkkkkkkkkkkkkkkkkkkkkkkkkkkkkkkkkkkkkkkkkkkkkllllllplllllllllllllllllllllllllllllllllplllllllBl
kykkkkkkkkkkkkkkkkkkkkokkkkkkqkkkkkkkkkkkkkkkkkkkkllllllllllllllllllllllllllllllllllllllllllllllllBl
kykkkkkkkkkkkkqkkkkkkkkkkkkkkkkkkkkkkkkkkkkkkkkkkkllllllllllllllllllllllllllllllplllllllllllllllllBl
kykkkkkkkkkkkkkkkkkkkkkkkkkkkkkkkkkkkkkkkkkkkkkkkkllllllllllllllllllllllllllllllllllllllllllllllllBl
kykkkkkkkkkkkkkkkkkkkkkkkkkkkkkkkkkkkkkkkkkkkkkkkkllllllllllllllllllllllllllllllllllllllllllllllllBl
kykkkkkkkkkkkkkkkkkkkkqkkkkkkkkkkkkkkkkkkkkkkkkkkkllllllllllllllllllllllllllllllllllllllllllllllllBl
kykkkkkkkkkkkkkkkkkkkkkkkkkkqkkkkkkkkkkkqkkkkkkkkkllllllllllllllllllllplllllllllllllllllllllllllllBl
kykkkkkkkkkkokkkkkkkkkkkkkkkkkkkkkokkkkkkkkkkkkkkklllllllllllllllllllllllllllllllllllrllllplllllllBl
kykkkkkkkkkkkkkkkkkkkkkkkkkkkkkkkkkkkkkkkkkkkkkkkkllllllllllrlllllllllllllllllrlllllllllllllllllllBl
kykkkkkkkkkkkkkkkkkkkkkkkkkkkkkkkkkkkkkkkkkkkkkkkkllllllllllllllllllllllllllllllllllllllllllllllllBl
kykkkkkkkkkkkkkkkkkkkkkkkkkkkkkkkkkqkkkkkkkkkkkkkkllllllllllllllllllllllllllllllllllllllllllllllllBl
kykkkkkkkkkkkkkkqkkkkkkkkkkkkkkkkkkkkkkkkkkkkkkkkkllllllllllllllllssslllllllllllllllllllllllllllllBl
kykkkkkkkqkkkkkkkkkkkkkkkkkkkkkkkkkkkkkkkkkkkkkkkklllllllllllllllsssssssssslllllllllllllllllllllllBl
kykkkkkkkkkkkkkkkkkkkkkkkkktttkkkkkkkkkkkkokkkkkkkllllllllpllllllsssssssssslllllllllllplllllllllllBl
kykkkkkkkkkkkkkkkkkkkkokkkttttttttttkkkkkkkkkkkkkklllllllllllllllsssssssssslllllllllllllllllllllllBl
kykkkkkkkkkkkkkkkkkkkkkkkkttttttttttkkkkkkkkkkkkkklllllllllllllllssssssssssllllpllllllllllrlllllllBl
kykkkkkkkkkkkkkkkkkkkkkkkkttttttttttkkkkqkkkkkkkkklllllllllllllllsssssssssslllllllllllllllllllllllBl
kykkkkkkkkkkkkkkokkkkkkkkkttttttttttkkkkkkkkkkkkkklllllllllllllllsssssssssslllllllllllllllllllllllBl
kykkkkkkkkkkkkkkkkkkkkkkkkttttttttttkkkkkkkkkkkkkklllllllpllllllllssslllllllllllllllllllllllllllllBl
kykkkkkkkkkqkkkkkkkkkkkkkkttttttttttkkkkkkkkkkkkkkllllllllllllllllllllllllllllllllllllllllllllllllBl
kykkkkkkkkkkkkkkkkkkkkkkkkktttkkkkkkkkkkkkokkkkkkkllllllllllllllllllllllllpllllllrllllllllllllllllBl
kykkkkkkkkkkkkkkkkkkkkkokkkkkkkkkkkqkkkkkkkkkkkkkklllllllllllllllllllllllllllllllllllllpllllllllllBl
kykkkkkkkkkkkkkkkkkkkkkkkkkkkkkkkkkkkkkkkkkkkkkkkkllllllllllllllllllllllllllllllllllllllllllllllllBl
kykkkkkkkkkkkkkkkkkkkkkkkkkkkkkkkkkkkkkkkkkkkkkkkkllllllllllllllllllllllllllllllllllllllllllllllllBl
kykkkkkkkkkkkkkkkkkkkkkkkkkkkkkkkkkkkokkkkkkkkkkkkllllllllllllllllllllllllllllllllllllllllllllllllBl
kykkkkkkkkkkkkkkqkkkkkkkkkqkkkkkkkkkkkkkqkkkkkkkkklllllllllllllllllpllllllllllllllllllllllllllllllBl
kykkkkkkkkkkkkkkkkkkkkkkkkkkkkkkkokkkkkkkkkkkkkkkklllllllllrlllllllllllllllrllllllllllllrlllllllllBl
kykkkkkkkkkkkkkkkkkkkkkkkkkkkkkkkkkkkkkkkkkkkkkkkkllllllllllllllllllllllllllllllllplllllllllllllllBl
kykkkkkkkkkkkkkkkkkkkkkkkkkkkkkkkkkkkkkkkkkkkkkkkkllllllllllllllllllllllllllllllllllllllllllllllllBl
kykkkkkkkkkqkkkkkkkkkkkkkkkkkkkkkkkkkkkkkkkkkkkkkkllllllllllllllllllllllllllllllllllllllllllllllllBl
kykkkkkkkkkkkkkkkkkkkkkkkkkkkkkkkkkkkkkkkkkkkkkkkkllllllllllllllllllllllllllllllllllllllllllllllllBl
kykkkkkkkkkkkkkkkkkkkkkkkkkkkkqkkkkkkkkkkkkkkkkkkkllllllllllllllllllllllllllllllllllllllllllllllllBl
kykkkkkkkkkkkkokkkkkkkokkkkkkkkkkkkkkkkkkkkkkkkkkklllllllllpllllllllllllllllllllllllllllllllplllllBl
kykkkkkkkkkkkkkkkkkkkkkkkkkkkkkkkkkkkkkkkkkkkkkkkklllllllllllllllllllllllpllllllllllllllllllllllllBl
kykkkkkkkkkkkkkkkkkkkkkkkkkkkkkkkkkkkqkkkkkkkkkkkkllllllllllllllrlllllllllllllllllllllllllllllllllBl
kykkkkkkkkkqkkkkkokkkkkkkkkkkkkkokkkkkkkkkkkkkkkkklllllllllllllllllllllllllllllllllllpllllllllllllBl
kykkkkkkkkkkkkkkkkkkkkkkqkkkkkkkkkkkkkkkkkkkkkkkkkllllllllllllllllllllllllllllllrlllllllllllllllllBl
kykkkkkkkkkkkkkkkkkkkkkkkkkkkkkkkkkkkkkkkkkkkkkkkkllllllllllllllllllllllllllllllllllllllllllllllllBl
kykkkkkkkkkkkkkkkkkkkkkkkkkkkkkkkkkkkkkkkkkkkkkkkkllllllllllllllllllllllllllllllllllllllllllllllllBl
kykkkkkkkkkkkkkkkkkkkkkkkkkkkkkkkkkkkkkkkkkkkkkkkkllllllllllllllllllllllllllllllllllllllllllllllllBl
kykkkkkkkkkkkkkkkkkkkkkkkkkkkkkkkkkkkkkkkkkkkkkkkkllllllllllllllllllllllllllllllllllllllllllllllllBl
kykkkkkkkkkkkkkkkkkkkkkkkkkkkkkkkkkkkkkkkkkkkkkkkkllllllllllllllllllllllllllllllllllllllllllllllllBl
kykkkkkkkkkkkkkkkkkkkkkkkkkkkkkkkkkkkkkkkkkkkkkkkkllllllllllllllllllllllllllllllllllllllllllllllllBl
kEEEEEEEEEEEEEEEEEEEEEEEEEEEEEEEEEEEEEEEEEEEEEEEEEFFFFFFFFFFFFFFFFFFFFFFFFFFFFFFFFFFFFFFFFFFFFFFFFBl
kkkkkkkkkkkkkkkkkkkkkkkkkkkkkkkkkkkkkkkkkkkkkkkkkkllllllllllllllllllllllllllllllllllllllllllllllllll
"}
